NO          ./texture/test.xpm       
          SO           ./texture/test.xpm				

WE ./texture/test.xpm  

EA        ./texture/test.xpm

F    255,50,50
C 18,  18, 18   

11111
100N1
10001
11111

    111
    101
    111