NO          ./textures/Brique-rouge.xpm       
          SO           ./textures/Pierres-moussues.xpm

WE ./textures/Pierres.xpm

EA        ./textures/Pierres-claires.xpm

F    55,50,50
C 18,  18, 18

111111111111111111111111111111111
100000000011000000000000111111111
101100000111000000000000111111111
100100000000000000000000111111111
111111111011000001110000000000001
100000000011000001110111111111111
111101111111110111000000100011111
111101111111110111010100100011111
110000001101010111000000100011111
100000000000000011000000100011111
10000000000000001101010000W011111
110000011101010111110111100011111
111101111111010111011110100011111
111111111111111111111111111111111
