NO       ./textures/Brique-rouge.xpm                
SO      ./textures/Pierres-moussues.xpm    


EA ./textures/Pierres-claires.xpm



WE                          ./textures/Pierres.xpm


 F    55          ,      50       , 50     
C 18,18,18

1111111111111111111111111
1000000000110000000000001
1011000001110000000000001
10010000000000S000000000111111111
111111111011000001110000000000001
100000000011000001110111111111111
 111111111111011100000010001
  110111111111011101010010001
11000000110101011100000010001
10000000000000001100000010001
100000000000001001101010010001
11000001110101011111011110001
  110111111101011101111010001
  111111111111111111111111111
