NO ./textures/Brique-rouge.xpm
SO ./textures/Pierres-moussues.xpm
WE ./textures/Night.xpm
EA ./textures/Sky.xpm

F 220,100,0
C 225,30,0

111111
1E0101
100001   111
110001   101
111111   111

