NO ./textures/Brique-rouge.xp
SO ./textures/Pierres-moussues.xpm
WE ./textures/Pierres.xpm
EA ./textures/Pierres-claires.xpm
F 220,100,0
C 225,30,0

 1111 
1S0101
100001
110001
 1111
