NO ./textures/Brique-rouge.xpm
SO ./textures/Pierres-moussues.xpm
WE ./textures/Pierres.xpm
EA ./textures/Pierres-claires.xpm
F 220,100,0
C 225,30,0

 1111 
1E0101
100001
112001
 1111
