NO ./textures/Brique-rouge.xpm
SO ./textures/Pierres-moussues.xpm
WE ./textures/Pierres.xpm
EA ./textures/Pierres-claires.xpm
F 220,111,119
C 225,,255

 1111 
1E0101
100001
110001
 1111
