NO ./textures/BRIQUES.xpm
SO ./textures/BRIQUES.xpm
WE ./textures/PIERRES.xpm
EA ./textures/PIERRES.xpm

F 220,100,0
C 225,30,0

111111
1N0101
100001
110001
111111