NO ./textures/Brique-rouge.xpm
SO ./textures/Pierres-moussues.xpm
WE ./textures/Night.xpm
EA ./textures/Sky.xpm

F 220,100,0
C 225,30,0

1111
1N21
1111
