NO ./textures/Brique-rouge.xpm
SO ./textures/Pierres-moussues.xpm
WE ./textures/Night.xpm
EA ./textures/Sky.xpm

F 220,100,0
C 225,30,0

11111
1N0S1
11111

